NO     Imgs/new5.xpm
SO    Imgs/new3.xpm
WE      Imgs/new2.xpm
EA        Imgs/new4.xpm

F 25,60,44
C      255,255,0

        1111111111111 11111111111
        10000000001101000000000001
        101100S001110000010000001
        1001000000000000000000001
111111111011000001110000000000001
100000000011000001110111110111111
11110111111111011100000010001
11110111111111011101010010001
11000000110101011100000010001
10000000001 10000001100000101
 1000100000100001101010010001
11000001110101011111011110001
11110111 1110101 101111010001
11111111 1111111 111111111111
